###############################
#           #       #         #
### ############# ### ### # ###
# # #   # #         # # # #   #
# # # ### ### ### ##### ##### #
#       # #   #   #       # # #
### ##### ### ### ### ##### # #
#       #   # #   # #         #
##### ### # ##### # ####### ###
# # #   # # #     #     #     #
# # # ### ### ##### ### # #####
# #               #   #       #
# # ### # ####### # ##### #####
#     # # #   #         # #   #
### # ####### ##### # ### # # #
#S# #   #   #     # #   # # # #
# # # ### ##### ### ##### ### #
#   # #   # #     #   #       #
# # # ### # # ##### # # # #####
# # #       #   # # # # #     #
##### # # # # ### # ##### ### #
#   # # # # #     #   #  F  # #
# ##### ### # ######### ### ###
# #   # # #     #     #   #   #
# # ##### # ##### ########### #
#     #       #   #           #
# # # # ### ##### # ####### # #
# # #     # #           # # # #
# # ##### # ### # ### ### ### #
# #   #   # #   #   #     #   #
###############################
